NO ./textures/north.xpm
WE ./textures/west.xpm
SO ./textures/south.xpm
EA ./textures/east.xpm

C 27,190,222
F 126,122,113

111111111111111111111111111111111111
1N1100001111000100001100000000000041
151151151110010101100001001001001111
101101121115110101111111011101100001
100001101000010100005000010100011111
111111101101010111111111110111001111
100000001101010000000000010000100001
151111111101011111111111011110111101
100000000001000000000021000000000001
111111111111111111111111111111111111
