NO ./textures/north.xpm
WE ./textures/west.xpm
SO ./textures/south.xpm
EA ./textures/east.xpm

C 225,30,0
F 220,100,0

1111111111111111111111111
1000000000110000000004001
1001100000111000000000001
1001000000000000000000001
1001000000000000000000001
1001000001110005000000001
1000000000110000011100111
1000001111111111110000001
1111001111111111111001001
1100000011000101110000001
1000000000000000110000001
1000000000000000111001001
1100000011110011111001111
1110011111110011111001111
1110011111110011110000001
1100000111000000110000001
1000000011000000110000001
1000000011111111111000111
1000000011111111111100111
1100000111000111111000111
1000000000000011010101001
1000000000000000000000001
1000000010000011111000001
1100000111000111111000111
11000001110001111110N0111
1111111111111111111111111