NO ./textures/north.xpm
SO ./textures/south.xpm
WE ./textures/west.xpm
EA ./textures/east.xpm

F 0,153,0
C 0,0,204

            1111111111111111111111111
            1000000000100000000000001
            1011000001110000000000001
            1001000000000000000000001
1111111111110000011100000000000011111
10000000001100000111011110001
11110111111111011100000010001
11110111111111011101010010001
11000000110101011100000010001
10000000000000001100000010001
10000000000000001101010010001
1100000111010101111101111N001
11110111 1110101 101111010001
11111111 1111111 111111111111
