NO ./textures/north.xpm
WE ./textures/west.xpm
SO ./textures/south.xpm
EA ./textures/east.xpm

C 27,190,222
F 126,122,113

1111111111111111111111111111111111
1000000001000000010000000000000001
1000111100011100010011111111111001
1000000111111101100100000000000001
1111000000000101000110000111111111
1111111111000101001100000100000001
1000000000000100011010000100001001
1000000010001000000100000000001001
1000000011111111111111111111110001
100E000000000000000000000000000001
1111111111111111111111111111111111